3 13 31
###############################
#p              *             #
# # # # # #3#*# #*#*# # # # # #
#  s     b*       *        ** #
# # # # #*#2# #*# #*# # # # # #
#   *     *       *     3  *  #
# #*# # # # # # # # # # # # # #
#  x *     *             ** * #
# # # # # # # # #4# # # # # # #
#   *      *            *     #
# # # # # # # # # # # #b#*# # #
#*  *  *  *  *        b       #
###############################
