3 13 31
###############################
#p     *                      #
# # # # #*# # #*# # # # # # # #
#        *     *   *  s   *   #
# # # # # # # # #*# # #*# # # #
#     *   x   *               #
# # #*# # # # # # # # #*# # #s#
#              1*     * * *   #
#*# # # # # #*# # # # # # #*# #
#             * * *  *      *b#
# # # #*# #*#*# # # # # # # # #
#      1     11  *    *f      #
###############################
