3 13 31
###############################
#p          *   *   * *       #
# #*# # # # # # #*# # # # # # #
#  x  * 4               *     #
# # # # # # # # # # # # # # # #
#3    f         *  ** *       #
# # # # # # # #*# # # #b# # # #
# 1*          *     *         #
# #*# #*# #*# # # #*#3# #*# #*#
#*   *             ** *       #
# # # # # #*# # # # #b# #*# # #
#  f                     *    #
###############################
