3 13 31
###############################
#p*                          *#
# # # # # # # #*# # # #*# # # #
#  *    *     *      *        #
# # # # #*# # # #b# # # # # # #
# * *        **               #
# # # # #*# # # # # # #*# # # #
#x  *           *  *  f **    #
# # # # #*# # # # # # #*# # # #
# *        *      *  b   4    #
#1#*# # # #*#*# # # # # # # #f#
#*3             1       *     #
###############################
