3 13 31
###############################
#p    * ** **  *     3        #
# # # # # # # # #s# # # # # # #
#                     *       #
# #*#*# # # # # # # # # # #*# #
# *                          *#
# # # #s#*# #*# # # # # # # # #
# 4 *     s      *      *3    #
# # # # # # # # # # # # # # #*#
#    *          *    *   *    #
# #x# #*#4#f# # # # # # # # # #
#** *      * *  *         *   #
###############################
